Dakar	Senegal
Túnez	Tunisia
Mogadiscio	Somalia
Doha	Katar
Lisboa	Portugal
Astana	Kazajstán
Lusaka	Zambia
Lima	Perú
Sofía	Bulgaria
Kigali	Ruanda
Londres	Inglaterra
Quito	Ecuador
Paramaribo	Surinam
Atenas	Grecia
Moscú	Rusia
Vilnius	Lituania
Budapest	Hungría
Nairobi	Kenia
Ottawa	Canadá
París	Francia
Tashkent	Uzbekistán
Roma	Italia
Harare	Zimbabue
Canberra	Australia
Kiev	Ucrania
Bruselas	Bélgica
Oslo	Noruega
Bamako	Malí
Berlín	Alemania
Tokio	Japón
Madrid	España
