Dakar	Senegal
Tunis	Tunezja
Mogadiszu	Somalia
Doha	Katar
Lizbona	Portugalia
Astana	Kazachstan
Lusaka	Zambia
Lima	Peru
Sofia	Bułgaria
Kigali	Rwanda
Londyn	Anglia
Quito	Ekwador
Paramaribo	Surinam
Ateny	Grecja
Moskwa	Rosja
Wilno	Litwa
Budapeszt	Węgry
Nairobi	Kenia
Ottawa	Kanada
Paryż	Francja
Taszkent	Uzbekistan
Rzym	Włochy
Harare	Zimbabwe
Canberra	Australia
Kijów	Ukraina
Bruksela	Belgia
Oslo	Norwegia
Bamako	Mali
Berlin	Niemcy
Tokio	Japonia
Madryt	Hiszpania
