Dakar	Senegal
Tunis	Tunisia
Mogadishu	Somalia
Doha	Qatar
Lisbon	Portugal
Astana	Kazakhstan
Lusaka	Zambia
Lima	Peru
Sofia	Bulgaria
Kigali	Rwanda
London	England
Quito	Ecuador
Paramaribo	Suriname
Athens	Greece
Moscow	Russia
Vilnius	Lithuania
Budapest	Hungary
Nairobi	Kenya
Ottawa	Canada
Paris	France
Tashkent	Uzbekistan
Rome	Italy
Harare	Zimbabwe
Canberra	Australia
Kiev	Ukraine
Brussels	Belgium
Oslo	Norway
Bamako	Mali
Berlin	Germany
Tokyo	Japan
Madrid	Spain
