verraco	sembrar
chico	chica
hermano	hermana
venado	venada
toro	vaca
papá	mamá
papi	mami
padre	madre
zorro	zorra
caballero	dama
abuelo	abuela
abu	abue
nieto	nieta
novio	novia
sabueso	puta
esposo	espasa
rey	reina
sobrino	sobrina
carnero	oveja
gallo	gallina
señor	señora
hijo	hija
semental	yegua
padrastro	madrastra
tío	tía
criado	criada
empresario	empresaria
héroe	heroína
policía	policía
pescador	pescadora
