सूअर	बोना
लड़का	लड़की
भाई	बहन
हिरन	हरिणी
बैल	गाय
पिता	माता
पिताजी	माँ
पिता	माता
लोमड़ी	लोमड़ी
सज्जन	महिला
दादा	दादी
दादा	दादी
पोता	पोती
दूल्हा	दुल्हन
शिकारीकुत्ता	कुतिया
पति	पत्नी
राजा	रानी
भतीजा	भतीजी
राम	भेड़
मुर्गा	मुर्गी
महोदय	महोदया
बेटा	बेटी
घोड़े	घोड़ी
सौतेलेपिता	सौतेलीमाँ
चाचा	चाची
सेवक	सेविका
नायक	नायिका
व्यापारी	व्यवसायी
पुलिस	पुलिस
मछुआरे	महिलामछुआरों
