boar	sow
boy	girl
brother	sister
buck	doe
bull	cow
dad	mom
daddy	mommy
father	mother
fox	vixen
gentleman	lady
grandfather	grandmother
grandpa	grandma
grandson	granddaughter
groom	bride
hound	bitch
husband	wife
king	queen
nephew	niece
ram	ewe
rooster	hen
sir	madam
son	daughter
stallion	mare
stepfather	stepmother
uncle	aunt
valet	maid
hero	heroine
businessman	businesswoman
policeman	policewoman
fisherman	fisherwoman
