Eber	Mutterschwein
Junge 	Mädchen
Bruder	Schwester
Rehbock	Geiß
Bulle	Kuh
Papa	Mama 
Daddy	Mammy
Vater	Mutter
Fuchs	Füchsin
Gentleman	Lady
Großvater	Großmutter
Opa	Oma
Enkel	Enkelin
Bräutigam	Braut
Libertin	Hure
Ehemann	Ehefrau
König	Königin
Neffe	Nichte
Bock	Mutterschaf
Hahn	Henne
Herr	Frau
Sohn	Tochter
Hengst 	Stute
Stiefvater	Stiefmutter
Onkel	Tante
Kammerdiener	Kammerdienerin
Geschäftsmann	Geschäftsfrau
Held	Heldin
Polizei	Polizistin
Fischer	Fischerin
