dzik	locha
chłopak	dziewczyna
brata	siostra
bryknięcie	łania
byk	krowa
tata	mama
tatuś	mamusia
ojciec	matka
lis	lisica
pan	pani
dziadek	babcia
dziadunio	babunia
wnuk	wnuczka
oblubieniec	oblubienica
ogar	suka
mąż	żona
król	królowa
bratanek	siostrzenica
baran	owca
kogut	kura
pan	pani
syn	córka
ogier	kobyła
ojczym	macocha
wujek	ciocia
kamerdyner	pokojówka
biznesmen	bizneswoman
bohater	bohaterka
policjant	policjantka
rybak	rybaczka
