verrat	truie
garçon	fille
frère	sœur
mâle	biche
taureau	vache
papa	mama
papa	mama
père	mère
renard	renarde
Monsieur	Dame
grandpère	grandmère
pépé	mémé
petitfils	petitefille
marié	mariée
chien	pute
mari	femme
Roi	reine
neveu	nièce
bélier	brebis
coq	poule
Monsieur	Madame
fils	fille
étalon	jument
beaupère	bellemère
oncle	tante
valet	servante
héros	héroïne
businessman	businesswoman
policier	policière
pêcheur	pêcheuse
