dream	dreams
machine	machines
hand	hands
horse	horses
banana	bananas
man	men
cow	cows
dollar	dollars
bottle	bottles
cloud	clouds
woman	women
pineapple	pineapples
pig	pigs
car	cars
pear	pears
lion	lions
cat	cats
elephant	elephants
eye	eyes
color	colors
mouse	mice
dog	dogs
mango	mangoes
bird	birds
rat	rats
goat	goats
onion	onions
snake	snakes
child	children
monkey	monkeys
melon	melons
