sueña	sueños
máquina	máquinas
mano	manos
caballo	caballos
plátano	plátanos
hombre	hombres
vaca	vacas
dólar	dólares
botella	botellas
nube	nubes
mujer	mujer
piña	piñas
cerdo	cerdos
auto	autos
pera	peras
león	leones
gato	gatos
elefante	elefantes
ojo	ojos
color	colores
ratón	ratones
perro	perros
mango	mangos
pájaro	pájaros
rata	ratas
cabra	cabras
cebolla	cebollas
serpiente	serpientes
niño	niños
mono	monos
melón	melones
