सपना	सपने
मशीन	मशीनें
हाथ	हाथ
घोड़ा	घोड़े
केला	केले
आदमी	पुरुषों
गाय	गायों
डॉलर	डॉलर
बोतल	बोतलें
बादल	बादलों
महिला	महिलाएं
अनानास	अनानास
सूअर	सूअरों
कार	कारें
नाशपाती	नाशपाती
शेर	शेर
बिल्ली	बिल्लियाँ
हाथी	हाथियों
आंख	आंखें
रंग	रंग
चूहा	चूहे
कुत्ता	कुत्ते
आम	आम
चिड़िया	पक्षियों
चूहा	चूहे
बकरी	बकरियां
प्याज	प्याज
साँप	साँप
बच्चा	बच्चे
बंदर	बंदर
खरबूज	खरबूजे
